+-+-+-+-+-+
|S|       |
+ + +-+ + +
|   | | | |
+ + + + +-+
| | | | | |
+ +-+ + + +
| |       |
+ +-+-+-+ +
| |      E|
+-+-+-+-+-+
